A	AH
A(2)	EY
CLEAR	K L IH R
COW	K AW
CREEPER	K R IY P ER
DIAMONDS	D AY M AH N D Z
GIVE	G IH V
HORSE	HH AO R S
JUMP	JH AH M P
MAKE	M EY K
ME	M IY
NIGHT	N AY T
PIG	P IH G
RAINY	R EY N IY
REGENERATION	R IY JH EH N ER EY SH AH N
SPAWN	S P AA N
SPAWN(2)	S P AO N
STORM	S T AO R M
SUNNY	S AH N IY
SWORD	S AO R D
THE	DH AH
THE(2)	DH IY
TIME	T AY M
VELOCITY	V AH L AA S AH T IY
WEATHER	W EH DH ER
WHAT'S	W AH T S
WHAT'S(2)	HH W AH T S
ZOMBIE	Z AA M B IY